E                                                                                          J
D                   a                                                                      G
F                  aJ                                                                      I
D                 aJ                         a                                             G
F                aJ                         aaa                                            I
D               aJ          aaa            aaaaa                                           G
F         a    aJ          aEBFa          aaaaaaa                                          I
D         Ja   J    a    aaEAAAFaa       aaaaaaaaa                                         G
F          Ja      aJ   EBBAAAAABBF    EBBBBBBBBBBBF                                       I
D           Ja    aJ    CAAAAAAAAAD    CAAAAAAAAAAAD                                       G
F            J   aJ                                                                        I
D               aJ                                                                         G
F               J                                      bbbbbbbbbbbbbbbbbbbbbbbbbbbbbbbbbbbbI
D                                                      bbbbbbbbbbbbbbbbbbbbbbbbbbbbbbbbbbbbG
F   1     J            J   0    0                      bbbbbbbbbbbbbbbbbbbbbbbbbbbbbbbbbbbbI
GEHEHEHEHEHEHEHEHEHEHEHEHEHEHEHEHEHEHEHEHEHEHEHEHEHEHEHEHEHEHEHEHEHEHEHEHEHEHEHEHEHEHEHEHEHG
IFIFIFIFIFIFIFIFIFIFIFIFIFIFIFIFIFIFIFIFIFIFIFIFIFIFIFIFIFIFIFIFIFIFIFIFIFIFIFIFIFIFIFIFIFII