E                                                                                          J
D                   a                                                                      I
F                  aJ                                                                      G
D                 aJ                         a                                             I
F                aJ                         aaa                                            G
D               aJ          aaa            aaaaa                                           I
F         a    aJ          aEBFa          aaaaaaa                                          G
D         Ja   J    a    aaEAAAFaa       aaaaaaaaa                                         I
F          Ja      aJ   EBBAAAAABBF    EBBBBBBBBBBBF                                       G
D           Ja    aJ    CAAAAAAAAAD    CAAAAAAAAAAAD                                       I
F            J   aJ                                                                        G
D               aJ                                                                         I
F               J                                      bbbbbbbbbbbbbbbbbbbbbbbbbbbbbbbbbbbbG
D                                                      bbbbbbbbbbbbbbbbbbbbbbbbbbbbbbbbbbbbI
F   1     J            J   0    0                      bbbbbbbbbbbbbbbbbbbbbbbbbbbbbbbbbbbbG
GEHEHEHEHEHEHEHEHEHEHEHEHEHEHEHEHEHEHEHEHEHEHEHEHEHEHEHEHEHEHEHEHEHEHEHEHEHEHEHEHEHEHEHEHEHI
IFIFIFIFIFIFIFIFIFIFIFIFIFIFIFIFIFIFIFIFIFIFIFIFIFIFIFIFIFIFIFIFIFIFIFIFIFIFIFIFIFIFIFIFIFIF