F                                                                                          E
D                   a                                                                      C
D                  aH                                                                      C
D                 aH                         a                                             C
D                aH                         aaa                                            C
D               aH          aaa            aaaaa                                           C
D         a    aH          aEBFa          aaaaaaa                                          C
D         Ha   H    a    aaEAAAFaa       aaaaaaaaa                                         C
D          Ha      aH   EBBAAAAABBF    EBBBBBBBBBBBF                                       C
D           Ha    aH    CAAAAAAAAAD    CAAAAAAAAAAAD                                       C
D            H   aH                                                                        C
D               aH                                                                         C
D               H                                      bbbbbbbbbbbbbbbbbbbbbbbbbbbbbbbbbbbbC
D                                                      bbbbbbbbbbbbbbbbbbbbbbbbbbbbbbbbbbbbC
D   1     H            H   0    0                      bbbbbbbbbbbbbbbbbbbbbbbbbbbbbbbbbbbbC
GBBBBBBBBBBBBBBBBBBBBBBBBBBBBBBBBBBBBBBBBBBBBBBBBBBBBBBBBBBBBBBBBBBBBBBBBBBBBBBBBBBBBBBBBBBG
